NO  ./textures/BlueWalls.xpm
SO  ./textures/BlueWalls.xpm
WE ./textures/BlueWalls.xpm

F   68, 168, 58
C   51, 004, 255

11111111111111111   1111111111111
10000000000000001   100011111    
10000000000000001   10001
1000000000000000111110001
1000000000000000000000001
1000000000000000000000001
1000000000000000000000001
1000000000100000000000001
1000000000000000000000001
1000000000000000000000001
1000000000000000000000001
1000000000000000000000001
1000000000000000000000001
1000000000000000000000001
1000000000000000000000001
1000000000000000000000001
1000000000000000000000001
1000000000000000000000001
1000000000000000000000001
11111000000000000000000011111
    1000000000000000000000001
11111000000000000000000011111
1000000000000000000000001
1000000000000000000000001
1111111111111111111111111