F  0,0,0
NO  ./textures/pillar.xpm
SO  ./textures/pillar.xpm
WE  ./textures/pillar.xpm
C 51, 004, 056
EA  ./textures/pillar.xpm


111111111111
1000000000W1
111111111111