NO  ./textures/BlueWalls.xpm
SO  ./textures/BlueWalls.xpm
F   48, 168, 58
WE  ./textures/BlueWalls.xpm

C   51, 004, 256

11111111111111111   1111111111111
10000000000000001   100011
10000000000000001   100011
1000000000000000111110001
1000000000000000000000001
1000000000000000000000001
1000000000000000000000001
1000000000100000000000001
1000000000000000000000001
1000000000000000000000001
1000000000000000000000001
1000000000000000000000001
1000000000000000000000001
1000000000000000000000001
1000000000000000000000001
1000000000000000000000001 
1000000000000000000000001
1000000000000000000000001
1000000000000000000000001
11111000000000000000000011111
    1000000000000000000000001
11111000000000000000000011111
1000000000000000000000001
1000000000000000000000001
1111111111111111111111111