NO  ./textures/BlueWalls.xpm
SO  ./textures/BlueWalls.xpm
WE  ./textures/BlueWalls.xpm
EA  ./textures/BlueWalls.xpm

F 48, 168, 58
C 51, 004, 056

111111111111111111111111111111111
11110001000011
10000000011011
100000001  100111111111
1011000P111011
11111111111111