NO  ./textures/BlueWalls.xpm
SO  ./textures/BlueWalls.xpm
WE  ./textures/BlueWalls.xpm
EA  ./textures/BlueWalls.xpm

F   48, 168, 58
C   51, 004, 256

11111111111111111   1111111111111
10000000000000001   100011
10000000000000001   100011
1000000000000000111110001
1000000000000000000000001
1000000000000000000000001
1000000000000000100000001
1000000000100001 P0000000001
100000000000000000000001
1000000000000000000000001
1000000000000001100000001
100000000000001  100000000001
10000000000001   10000000000001
100000000000001 100000000001
1000000000000001000000001
1000000000000000000000001 
1000000000000000000000001
1000000000000000000000001
1000000000000000000000001
11111000000000000000000011111
    1000000000000000000000001
11111000000000000000000011111
1000000000000000000000001
1000000000000000000000001
1111111111111111111111111