
SO ./textures/122.xpm

WE ./textures/122.xpm

EA ./textures/BlueWalls.xpm

NO ./textures/122.xpm

C  255, 155, 0     

F  255   , 0, 0

1111111111111
1000000000001
1000000000001
1011111111101
100000N000101
1011111111101
1000000000001
1000000000001
1111111111111
