NO  ./textures/BlueWalls.xpm
SO  ./textures/BlueWalls.xpm
WE  ./textures/BlueWalls.xpm
EA  ./textures/BlueWalls.xpm

F 48, 168, 58
C 51, 004, 056

1111 1111P111