NO  ./Archive/space3.xpm
SO  ./Archive/space3.xpm
WE  ./Archive/space3.xpm
EA  ./Archive/space3.xpm

F 0, 0, 0
C 51, 004, 056


11111
111111111111111111111111111111111111111111111111
100000000000000000000000000000000000000000000001
10000000000100000000000000000000000000000000000111111111111111111
10000000000N10000000000011111111111111111100000000000000000000001
1000000000000000000000001                100000000000000000000001
1000000000000000000000001                111111111111111100000001
1000000000000000000000001                               100000001
100000000000010000000001                                100000001
11111111111111111111111111111111                         100000001
1000000000000000000000001                               100000001
11111111111111111111111111111111                        100000001
1000000000001000000000001                               1000000011111111111111111111111111
100000000001000000000001                                10000000000000000000000000000000011111111
100000000000000000000001                                10000000111111111111111111111111111
1000000001111111111111111                               100000001
1000000001                                              100000001
1000000001                                              100000001
111111111                                               11111111
10000000011111111111111111111111111111111111111111111111100000001
10000000011000000001000000001000000001000000001000000001000000001
10000000000100000001000000001000000001000000001000000001000000001
10000000011000000001000000001000000001000000001000000001000000001
11111111111111111111111111111111111111111111111111111111111111111
1111111111111
1111111111111
1111111111111
