NO  ./textures/BlueWalls.xpm
SO  ./textures/BlueWalls.xpm
WE  ./textures/BlueWalls.xpm
EA  ./textures/BlueWalls.xpm

F 48, 168, 58
C 51, 004, 056



1111111111111111111111111
1000000000000000000000001
1000000000010000000000001
1000000000000000000000001
10000000000E0000000000001
1000000000000000000000001
1111111111111111111111111