NO  ./textures/BlueWalls.xpm
SO  ./textures/BlueWalls.xpm
WE  ./textures/BlueWalls.xpm
EA  ./textures/BlueWalls.xpm

F 48, 168, 58
C 51, 004, 056



11111111111111111   11111
100000N0000000001   10001
10000000000000001   10001
1000000000000000111110001
1000000000000000000000001
1000000000000000000000001
1000000000000000000000001
100000000000000000000001
1000000000011110000000001
1000000000010010000000001
1000000000011110000000001
1000000000100000000000001
1000000000000000000000001
1000000000000000000000001
1000000000000000000000001
1000000000000000000000001
1000000000000000000000001
1000000000000000000000001
1000000000000000000000001
11111000000000000000000011111
    1000000000000000000011111
11111000000000000000000011111
1000000000000000000000001
1000000000000000000000001
1111111111111111111111111