NO  ./textures/BlueWalls.xpm
SO  ./textures/BlueWalls.xpm
WE  ./textures/BlueWalls.xpm
EA  ./textures/BlueWalls.xpm

F 48, 168, 58
C 51, 004, 056



11111111111111
10000000000011
10000000000011
10000000000S11
11111111111111