NO  ./textures/BlueWalls.xpm
SO  ./textures/BlueWalls.xpm
WE  ./textures/BlueWalls.xpm
EA  ./textures/BlueWalls.xpm

F 48, 168, 58
C 51, 004, 056



11111111111111
11110000000011
10000000000011
10000000000011
1011000N111011
111111111111111
111111111111111
11111111111111
11110000000011
10000000000011
10000000000011
10110001111011
111111111111111
111111111111111
11111111111111
11110000000011
10000000000011
10000000000011
10110001111011
111111111111111
111111111111111
11111111111111