NO  ./textures/BlueWalls.xpm
SO  ./textures/BlueWalls.xpm
WE  ./textures/BlueWalls.xpm
EA  ./textures/BlueWalls.xpm

F 48, 168, 58
C 51, 004, 056



111111111111111111111111111111111111111111111111
10000000000N000000000000000000000000000000000001
10000000000100000000000000000000000000000000000111111111111111111
10000000000010000000000011111111111111111100000000000000000000001
1000000000000000000000001                100000000000000000000001
1000000000000000000000001                111111111111111100000001
1000000000000000000000001                               100000001
1000000000000000000000001                               100000001
1000000000000000000000001                               100000001
1000000000000000000000001                               1000000011111111111111111111111111
1000000000000000000000001                               1000000000000000000000000000000001
1000000000000000000000001                               1000000011111111111111111111111111
1000000001111111111111111                               100000001
1000000001                                              100000001
1000000001                                              100000001
10000000011111111111111111111111111111111111111111111111100000001
10000000011000000001000000001000000001000000001000000001000000001
10000000011000000001000000001000000001000000001000000001000000001
10000000011000000001000000001000000001000000001000000001000000001

11111111111111111111111111111111111111111111111111111111111111111